%%%%%%%%%%%%%%%%%%%%%%%%%%%%%%%%%%%%%%%%%%%%%%%%%
% .  %.        %             %  .%     % %   %  %
%    %%%% %%%%%% %  % % %%         %%%%  %. %%% %
%    %.%    % .% %  % %  %   %   %          %   %
%   .            %.     %%%% %   %% .%%% %      %
% %%%%% %%%%%%  %%%% %           .%    %. %%%%%%%
%.      %   .%       .% %%%  %%%%%%  % %  %   % %
%%% %%  % %%%%%%% %%%%% %    %  . %% % %    %.% %
%    %  %      %  %      P% %%       %   %%%% % %
%.      %   %  %  %     %          %       .%   %
% % %%%   .% %    %% %% %%% %% %  %.%%%%%%%%%%% %
%   %    %    %              %    %             %
%%%%%%%%%%%%%%%%%%%%%%%%%%%%%%%%%%%%%%%%%%%%%%%%%
